rrrrrrrrrrrrrr......
r............r......
r..rrr..ggg..r......
r.r...rg...g.r......
r.rrrr..gg...r......
r.r.s.....g..rrrrrrr
r..rrr.ggg.........r
r..bbb...rrr.g.gg..r
r.b...b.r...rgg..g.r
r..bb...rrrr.g...g.r
r....b..r....g...g.r
r..bbb...rrr.g...g.r
r..ggg.b...b.......r
r.g...gb...b.rrrrrrr
r..gg..b...b.r......
r....g.b..bb.r......
r.ggg...bb.b.r......
r............r......
rrrrrrrrrrrrrr......