##########
#........#
#.#......#
#........#
##########